XXXXXXXXXXXXXXX
M     X  X    X
X  XX X XX X  X
X X  XX    XXXX
X    X X XXX XX
X  X X X   X  X
X XX X  XX   XX
X XX  X  XXX XX
X   X  X    XXX
XXX  X XXX XX X
X  X X X X    X
XX X XX  XXX XX
X       XX   XX
X X X X    X  G
XXXXXXXXXXXXXXX
